"a" = (/turf/unsimulated/map/edge,/area/overmap)
"b" = (/turf/unsimulated/map,/area/overmap)
"c" = (/obj/effect/overmap/event/carp,/turf/unsimulated/map,/area/overmap)
"d" = (/obj/effect/overmap/event/electric,/turf/unsimulated/map,/area/overmap)
"e" = (/obj/effect/overmap/event/dust,/turf/unsimulated/map,/area/overmap)
"f" = (/obj/effect/overmap/oesepilus,/obj/effect/overmap_effect_spawner/asteroids,/obj/effect/overmap_effect_spawner/comets,/obj/effect/overmap_effect_spawner/rich_asteroid,/turf/unsimulated/map,/area/overmap)

(1,1,1) = {"
aaaaaaaaaaaaaaaaaaaaaaaaaaaaaaaaaaaaaaaaaaaaaaaaaa
abbbbbbbbbbbbbbbbbbbbbbbbbbbbbbbbbbbbbbbbbbbbbbbba
abbbbbbbbbbbbbbbbbbbbbbbbbbbbbbbbbbbbbbbbbbbbbbbba
abbbbbbbbbbbbbbbbbbbbbbbbbbbbbbbbbbbbbbbbbbbbbbbba
abbbbbbbbbbbbbbbbbbbbbbbbbbbbbbbbbbbbbbbbbbbbbbbba
abbbbbbbbbbbbccccbbbbbbbbbbbbbbbbbbbbbbbbbbbbbbbba
abbbbbbbbbbbcccccbbbbbbbbbbbbbbbbbbbbbbbbbbbbbbbba
abbbbbbbbbbccccbbbbbbbbbbbbbbbbbbbbbbccbcbbbbbbbba
abbbbbbbbbcccbbbbbbbbbbbbbbbbbbbbbbbbbccccbbbbbbba
abbbbbbbbbccccbbbbbbbbbbbbbbbbbbbbbbbbbccccbbbbbba
abbbbbbbbbbbbbbbbbbbbbbbbbbbbbbbbbbbbbbcccccbbbbba
abbbbbbbbbbbbbbbbbbbbbbbbbbbbbbbbbbbbbbbbccccbbbba
abbbbbbbbbbbbbbbbbbbbbbbbbbbbbbbbbbbbbbbbbbbbbbbba
abbbbbbbbbbbbbbbbbbbbbbbbbbbbbbbbbbbbbbbbbbbbbbbba
abbbbbbbbbbbbbbbbbbbbbbbbbbbbbbbbbbbbbbbbbbbbbbbba
abbbbbbbbbbbbbbbbbbbbbbbbbbbbbbbbbbbbbbbbbbbbbbbba
abbbbbbbbbbbbbbbbbbbbbbbbbbbbbbbbbbbbbbbbbccbbbbba
abbbbbbbbbbbbbbbbbbbbbbbbbbbbbbbbbbbbbbbbbccbbbbba
abbbbbbbbbbbbbbbbbbbbbbbbbbbbbbbbbbbbbbbbbcccbbbba
abbbbbbbbbbbbbbbbbbbbbbbbbbbbbbbbbbbbbbbbbcccbbbba
abbbbbbbbbbbbbbbbbbbbbbbbbbbbbbbbbbbbbbbbbcccbbbba
abbbbbbbbbbbbbbddbbbbbbbbbbbbbbbbbddbbbbbbbbbbbbba
abbbbbeebbbbbbbdbbbbbbebbbbbbbbbbbbddbbbbbbbbbbbba
abbbbbbebbbbbbbdbbbbbeebbbebbbbbbbbbddbbbbbbbbbbba
abbbbbbebbbbbbddbbbbebbbbbbeebbbbbbbbdbbbbbbbbbbba
abbbbbeebbbbbbdbbbbbebbbfbbbebbbbbbdddbbbbbbbbbbba
abbbbbebbbbbbbbbbbbbbcbbbbbbbebbbbbbddbbbbbbbbbbba
abbbbbebbbbbbbbbbbbbbccccbbbbbbbbbbbddbbbbbbbbbbba
abbbbbbbbbbbbbbbbbbbbeeccbbbbbbbbbbbbdbbbbbbbbbbba
abbbbbbbbbbbbbbbbbbbbbeecbbbbbbbbbbbbbbbbbbbbbbbba
abbbbbbbbbbbdbbbbbbbbbbbbbbbbbbddbbbbbbbbbbbbbbbba
abbbbbbbbbbbddbbbbbbbbbbbbbbbbbdbbbbbbbbbbbbbbbbba
abbbbbbbbbbbbddbbbbbbbbbbbbbbbddbbbbbbbbbbbbbbbbba
abbbbbbbbbbbbbddbbbbbbbbbbbbbddbbbbbbbbbbbbbbbbbba
abbbbbbbbbbbbbddbbbbbbbbbbbdddbbbbbbbbbbbbbbbbbbba
abbbbbbbbbbbbbbddbbbbbbbbbbbbbbbbbbbbbbbbbbbbbbbba
abbbbbbbbbbbbbbbdbbbbbbbbbbbbbbbbbbbbbbbbbbbbbbbba
abbbbbbbbbbbbbbbbbbbbbbbbbbbbbbbbbbbbbbbbbbbbbbbba
abbbbbbbbbbbbbbbbbbbbbbbbbbbbbbbbbbbbbbbbbbbbbbbba
abbbbbbbbbbbbbbbbbbbbbddddbbbbbbbbbbbbbbbbbbbbbbba
abbbbbbbbbbbbbbbbbbbbbddddddbbbbbbbbbbbbbbbbbbbbba
abbbbbccbbbbbbbbbbbbbbbbbbbdbbbbbbbbbbccbbbbbbbbba
abbbbbcccbbbbbbbbbbbbbbbbbbbbbbbbbbbccccbbbbbbbbba
abbbbbbccccbbbbbbbbbbbbbbbbbbbbbbbbbcccbbbbbbbbbba
abbbbbbbbcccbbbbbbbbbbbbbbbbbbbbbbbbbbbbbbbbbbbbba
abbbbbbbbbccbbbbbbbbbbbbbbbbbbbbbbbbbbbbbbbbbbbbba
abbbbbbbbbbbbbbbbbbbbbbbbbbbbbbbbbbbbbbbbbbbbbbbba
abbbbbbbbbbbbbbbbbbbbbbbbbbbbbbbbbbbbbbbbbbbbbbbba
abbbbbbbbbbbbbbbbbbbbbbbbbbbbbbbbbbbbbbbbbbbbbbbba
aaaaaaaaaaaaaaaaaaaaaaaaaaaaaaaaaaaaaaaaaaaaaaaaaa
"}
