//MAP CONVERTED BY dmm2tgm.py THIS HEADER COMMENT PREVENTS RECONVERSION, DO NOT REMOVE
"a" = (
/turf/unsimulated/map/edge,
/area/overmap)
"b" = (
/turf/unsimulated/map,
/area/overmap)
"c" = (
/obj/effect/overmap/event/carp,
/turf/unsimulated/map,
/area/overmap)
"d" = (
/obj/effect/overmap/event/electric,
/turf/unsimulated/map,
/area/overmap)
"e" = (
/obj/effect/overmap/event/dust,
/turf/unsimulated/map,
/area/overmap)
"f" = (
/obj/effect/overmap/star/oesepilus,
/obj/effect/overmap/overmap_effect_spawner/asteroids,
/obj/effect/overmap/overmap_effect_spawner/comets,
/obj/effect/overmap/overmap_effect_spawner/rich_asteroid,
/turf/unsimulated/map,
/area/overmap)

(1,1,1) = {"
a
a
a
a
a
a
a
a
a
a
a
a
a
a
a
a
a
a
a
a
a
a
a
a
a
a
a
a
a
a
a
a
a
a
a
a
a
a
a
a
a
a
a
a
a
a
a
a
a
a
"}
(2,1,1) = {"
a
b
b
b
b
b
b
b
b
b
b
b
b
b
b
b
b
b
b
b
b
b
b
b
b
b
b
b
b
b
b
b
b
b
b
b
b
b
b
b
b
b
b
b
b
b
b
b
b
a
"}
(3,1,1) = {"
a
b
b
b
b
b
b
b
b
b
b
b
b
b
b
b
b
b
b
b
b
b
b
b
b
b
b
b
b
b
b
b
b
b
b
b
b
b
b
b
b
b
b
b
b
b
b
b
b
a
"}
(4,1,1) = {"
a
b
b
b
b
b
b
b
b
b
b
b
b
b
b
b
b
b
b
b
b
b
b
b
b
b
b
b
b
b
b
b
b
b
b
b
b
b
b
b
b
b
b
b
b
b
b
b
b
a
"}
(5,1,1) = {"
a
b
b
b
b
b
b
b
b
b
b
b
b
b
b
b
b
b
b
b
b
b
b
b
b
b
b
b
b
b
b
b
b
b
b
b
b
b
b
b
b
b
b
b
b
b
b
b
b
a
"}
(6,1,1) = {"
a
b
b
b
b
b
b
b
b
b
b
b
b
b
b
b
b
b
b
b
b
b
b
b
b
b
b
b
b
b
b
b
b
b
b
b
b
b
b
b
b
b
b
b
b
b
b
b
b
a
"}
(7,1,1) = {"
a
b
b
b
b
b
b
b
b
b
b
b
b
b
b
b
b
b
b
b
b
b
e
b
b
e
e
e
b
b
b
b
b
b
b
b
b
b
b
b
b
c
c
b
b
b
b
b
b
a
"}
(8,1,1) = {"
a
b
b
b
b
b
b
b
b
b
b
b
b
b
b
b
b
b
b
b
b
b
e
e
e
e
b
b
b
b
b
b
b
b
b
b
b
b
b
b
b
c
c
c
b
b
b
b
b
a
"}
(9,1,1) = {"
a
b
b
b
b
b
b
b
b
b
b
b
b
b
b
b
b
b
b
b
b
b
b
b
b
b
b
b
b
b
b
b
b
b
b
b
b
b
b
b
b
b
c
c
b
b
b
b
b
a
"}
(10,1,1) = {"
a
b
b
b
b
b
b
b
b
b
b
b
b
b
b
b
b
b
b
b
b
b
b
b
b
b
b
b
b
b
b
b
b
b
b
b
b
b
b
b
b
b
b
c
c
b
b
b
b
a
"}
(11,1,1) = {"
a
b
b
b
b
b
b
b
c
c
b
b
b
b
b
b
b
b
b
b
b
b
b
b
b
b
b
b
b
b
b
b
b
b
b
b
b
b
b
b
b
b
b
c
c
c
b
b
b
a
"}
(12,1,1) = {"
a
b
b
b
b
b
b
c
c
c
b
b
b
b
b
b
b
b
b
b
b
b
b
b
b
b
b
b
b
b
b
b
b
b
b
b
b
b
b
b
b
b
b
b
c
c
b
b
b
a
"}
(13,1,1) = {"
a
b
b
b
b
b
c
c
c
c
b
b
b
b
b
b
b
b
b
b
b
b
b
b
b
b
b
b
b
b
d
d
b
b
b
b
b
b
b
b
b
b
b
b
b
b
b
b
b
a
"}
(14,1,1) = {"
a
b
b
b
b
c
c
c
b
c
b
b
b
b
b
b
b
b
b
b
b
b
b
b
b
b
b
b
b
b
b
d
d
b
b
b
b
b
b
b
b
b
b
b
b
b
b
b
b
a
"}
(15,1,1) = {"
a
b
b
b
b
c
c
c
b
b
b
b
b
b
b
b
b
b
b
b
b
b
b
b
d
d
b
b
b
b
b
b
d
d
d
b
b
b
b
b
b
b
b
b
b
b
b
b
b
a
"}
(16,1,1) = {"
a
b
b
b
b
c
c
b
b
b
b
b
b
b
b
b
b
b
b
b
b
d
d
d
d
b
b
b
b
b
b
b
b
d
d
d
b
b
b
b
b
b
b
b
b
b
b
b
b
a
"}
(17,1,1) = {"
a
b
b
b
b
c
c
b
b
b
b
b
b
b
b
b
b
b
b
b
b
d
b
b
b
b
b
b
b
b
b
b
b
b
b
d
d
b
b
b
b
b
b
b
b
b
b
b
b
a
"}
(18,1,1) = {"
a
b
b
b
b
b
b
b
b
b
b
b
b
b
b
b
b
b
b
b
b
b
b
b
b
b
b
b
b
b
b
b
b
b
b
b
b
b
b
b
b
b
b
b
b
b
b
b
b
a
"}
(19,1,1) = {"
a
b
b
b
b
b
b
b
b
b
b
b
b
b
b
b
b
b
b
b
b
b
b
b
b
b
b
b
b
b
b
b
b
b
b
b
b
b
b
b
b
b
b
b
b
b
b
b
b
a
"}
(20,1,1) = {"
a
b
b
b
b
b
b
b
b
b
b
b
b
b
b
b
b
b
b
b
b
b
b
b
b
b
b
b
b
b
b
b
b
b
b
b
b
b
b
b
b
b
b
b
b
b
b
b
b
a
"}
(21,1,1) = {"
a
b
b
b
b
b
b
b
b
b
b
b
b
b
b
b
b
b
b
b
b
b
b
b
e
e
b
b
b
b
b
b
b
b
b
b
b
b
b
b
b
b
b
b
b
b
b
b
b
a
"}
(22,1,1) = {"
a
b
b
b
b
b
b
b
b
b
b
b
b
b
b
b
b
b
b
b
b
b
b
e
b
b
c
c
e
b
b
b
b
b
b
b
b
b
b
b
b
b
b
b
b
b
b
b
b
a
"}
(23,1,1) = {"
a
b
b
b
b
b
b
b
b
b
b
b
b
b
b
b
b
b
b
b
b
b
e
e
b
b
b
c
e
e
b
b
b
b
b
b
b
b
b
d
d
b
b
b
b
b
b
b
b
a
"}
(24,1,1) = {"
a
b
b
b
b
b
b
b
b
b
b
b
b
b
b
b
b
b
b
b
b
b
b
b
b
b
b
c
c
e
b
b
b
b
b
b
b
b
b
d
d
b
b
b
b
b
b
b
b
a
"}
(25,1,1) = {"
a
b
b
b
b
b
b
b
b
b
b
b
b
b
b
b
b
b
b
b
b
b
b
b
b
f
b
c
c
c
b
b
b
b
b
b
b
b
b
d
d
b
b
b
b
b
b
b
b
a
"}
(26,1,1) = {"
a
b
b
b
b
b
b
b
b
b
b
b
b
b
b
b
b
b
b
b
b
b
b
b
b
b
b
b
b
b
b
b
b
b
b
b
b
b
b
d
d
b
b
b
b
b
b
b
b
a
"}
(27,1,1) = {"
a
b
b
b
b
b
b
b
b
b
b
b
b
b
b
b
b
b
b
b
b
b
b
e
b
b
b
b
b
b
b
b
b
b
b
b
b
b
b
b
d
b
b
b
b
b
b
b
b
a
"}
(28,1,1) = {"
a
b
b
b
b
b
b
b
b
b
b
b
b
b
b
b
b
b
b
b
b
b
b
b
e
b
b
b
b
b
b
b
b
b
d
b
b
b
b
b
d
d
b
b
b
b
b
b
b
a
"}
(29,1,1) = {"
a
b
b
b
b
b
b
b
b
b
b
b
b
b
b
b
b
b
b
b
b
b
b
b
e
e
b
b
b
b
b
b
b
b
d
b
b
b
b
b
b
b
b
b
b
b
b
b
b
a
"}
(30,1,1) = {"
a
b
b
b
b
b
b
b
b
b
b
b
b
b
b
b
b
b
b
b
b
b
b
b
b
b
e
b
b
b
b
b
b
d
d
b
b
b
b
b
b
b
b
b
b
b
b
b
b
a
"}
(31,1,1) = {"
a
b
b
b
b
b
b
b
b
b
b
b
b
b
b
b
b
b
b
b
b
b
b
b
b
b
b
b
b
b
b
b
d
d
b
b
b
b
b
b
b
b
b
b
b
b
b
b
b
a
"}
(32,1,1) = {"
a
b
b
b
b
b
b
b
b
b
b
b
b
b
b
b
b
b
b
b
b
b
b
b
b
b
b
b
b
b
d
d
d
b
b
b
b
b
b
b
b
b
b
b
b
b
b
b
b
a
"}
(33,1,1) = {"
a
b
b
b
b
b
b
b
b
b
b
b
b
b
b
b
b
b
b
b
b
b
b
b
b
b
b
b
b
b
d
b
b
b
b
b
b
b
b
b
b
b
b
b
b
b
b
b
b
a
"}
(34,1,1) = {"
a
b
b
b
b
b
b
b
b
b
b
b
b
b
b
b
b
b
b
b
b
b
b
b
b
b
b
b
b
b
b
b
b
b
b
b
b
b
b
b
b
b
b
b
b
b
b
b
b
a
"}
(35,1,1) = {"
a
b
b
b
b
b
b
b
b
b
b
b
b
b
b
b
b
b
b
b
b
d
b
b
b
b
b
b
b
b
b
b
b
b
b
b
b
b
b
b
b
b
b
b
b
b
b
b
b
a
"}
(36,1,1) = {"
a
b
b
b
b
b
b
b
b
b
b
b
b
b
b
b
b
b
b
b
b
d
d
b
b
d
b
b
b
b
b
b
b
b
b
b
b
b
b
b
b
b
b
b
b
b
b
b
b
a
"}
(37,1,1) = {"
a
b
b
b
b
b
b
b
b
b
b
b
b
b
b
b
b
b
b
b
b
b
d
d
b
d
d
d
b
b
b
b
b
b
b
b
b
b
b
b
b
b
c
c
b
b
b
b
b
a
"}
(38,1,1) = {"
a
b
b
b
b
b
b
c
b
b
b
b
b
b
b
b
b
b
b
b
b
b
b
d
d
d
d
d
d
b
b
b
b
b
b
b
b
b
b
b
b
b
c
c
b
b
b
b
b
a
"}
(39,1,1) = {"
a
b
b
b
b
b
b
c
c
b
b
b
b
b
b
b
b
b
b
b
b
b
b
b
b
b
b
b
b
b
b
b
b
b
b
b
b
b
b
b
b
c
c
c
b
b
b
b
b
a
"}
(40,1,1) = {"
a
b
b
b
b
b
b
b
c
c
c
b
b
b
b
b
b
b
b
b
b
b
b
b
b
b
b
b
b
b
b
b
b
b
b
b
b
b
b
b
b
c
c
b
b
b
b
b
b
a
"}
(41,1,1) = {"
a
b
b
b
b
b
b
c
c
c
c
b
b
b
b
b
b
b
b
b
b
b
b
b
b
b
b
b
b
b
b
b
b
b
b
b
b
b
b
b
b
b
b
b
b
b
b
b
b
a
"}
(42,1,1) = {"
a
b
b
b
b
b
b
b
c
c
c
c
b
b
b
b
b
b
b
b
b
b
b
b
b
b
b
b
b
b
b
b
b
b
b
b
b
b
b
b
b
b
b
b
b
b
b
b
b
a
"}
(43,1,1) = {"
a
b
b
b
b
b
b
b
b
c
c
c
b
b
b
b
c
c
c
c
c
b
b
b
b
b
b
b
b
b
b
b
b
b
b
b
b
b
b
b
b
b
b
b
b
b
b
b
b
a
"}
(44,1,1) = {"
a
b
b
b
b
b
b
b
b
b
c
c
b
b
b
b
c
c
c
c
c
b
b
b
b
b
b
b
b
b
b
b
b
b
b
b
b
b
b
b
b
b
b
b
b
b
b
b
b
a
"}
(45,1,1) = {"
a
b
b
b
b
b
b
b
b
b
b
c
b
b
b
b
b
b
c
c
c
b
b
b
b
b
b
b
b
b
b
b
b
b
b
b
b
b
b
b
b
b
b
b
b
b
b
b
b
a
"}
(46,1,1) = {"
a
b
b
b
b
b
b
b
b
b
b
b
b
b
b
b
b
b
b
b
b
b
b
b
b
b
b
b
b
b
b
b
b
b
b
b
b
b
b
b
b
b
b
b
b
b
b
b
b
a
"}
(47,1,1) = {"
a
b
b
b
b
b
b
b
b
b
b
b
b
b
b
b
b
b
b
b
b
b
b
b
b
b
b
b
b
b
b
b
b
b
b
b
b
b
b
b
b
b
b
b
b
b
b
b
b
a
"}
(48,1,1) = {"
a
b
b
b
b
b
b
b
b
b
b
b
b
b
b
b
b
b
b
b
b
b
b
b
b
b
b
b
b
b
b
b
b
b
b
b
b
b
b
b
b
b
b
b
b
b
b
b
b
a
"}
(49,1,1) = {"
a
b
b
b
b
b
b
b
b
b
b
b
b
b
b
b
b
b
b
b
b
b
b
b
b
b
b
b
b
b
b
b
b
b
b
b
b
b
b
b
b
b
b
b
b
b
b
b
b
a
"}
(50,1,1) = {"
a
a
a
a
a
a
a
a
a
a
a
a
a
a
a
a
a
a
a
a
a
a
a
a
a
a
a
a
a
a
a
a
a
a
a
a
a
a
a
a
a
a
a
a
a
a
a
a
a
a
"}
