"aa" = (/obj/effect/quadrant_border/betaquadrant,/turf/unsimulated/map/edge,/area/overmap)
"ab" = (/obj/effect/quadrant_border/borderterritory,/turf/unsimulated/map/edge,/area/overmap)
"ac" = (/obj/effect/quadrant_border/betaquadrant,/turf/unsimulated/map,/area/overmap)
"ad" = (/obj/effect/quadrant_border/borderterritory,/turf/unsimulated/map,/area/overmap)
"ae" = (/obj/effect/quadrant_border/wildspace,/turf/unsimulated/map,/area/overmap)
"af" = (/obj/effect/quadrant_border/alphaquadrant,/turf/unsimulated/map,/area/overmap)
"ag" = (/obj/effect/quadrant_border/southernrim,/turf/unsimulated/map/edge,/area/overmap)
"ah" = (/obj/effect/quadrant_border/southernrim,/turf/unsimulated/map,/area/overmap)
"ai" = (/obj/effect/quadrant_border/trasenterritory,/turf/unsimulated/map,/area/overmap)
"aj" = (/obj/effect/quadrant_border/hamletjean,/turf/unsimulated/map,/area/overmap)
"ak" = (/obj/effect/quadrant_border/xanadu,/turf/unsimulated/map,/area/overmap)
"al" = (/obj/effect/quadrant_border/alphaquadrant,/turf/unsimulated/map/edge,/area/overmap)
"am" = (/obj/effect/quadrant_border/neutralzone,/turf/unsimulated/map,/area/overmap)
"an" = (/obj/effect/quadrant_border/neutralzone,/turf/unsimulated/map/edge,/area/overmap)
"ao" = (/obj/effect/quadrant_border/bufferzone,/turf/unsimulated/map,/area/overmap)
"ap" = (/obj/effect/quadrant_border/thepeel,/turf/unsimulated/map,/area/overmap)
"aq" = (/obj/effect/quadrant_border/hopefullanding,/turf/unsimulated/map,/area/overmap)
"ar" = (/obj/effect/quadrant_border/thepeel,/obj/effect/overmap/oesepilus,/turf/unsimulated/map,/area/overmap)
"as" = (/obj/effect/quadrant_border/domdaniel,/turf/unsimulated/map,/area/overmap)
"at" = (/obj/effect/quadrant_border/southernrim,/obj/effect/overmap/event/meteor/asteroid,/turf/unsimulated/map,/area/overmap)
"au" = (/obj/effect/quadrant_border/betaquadrant,/obj/effect/overmap/event/meteor/quadrant/asteroid,/turf/unsimulated/map,/area/overmap)
"av" = (/obj/effect/quadrant_border/betaquadrant,/obj/effect/overmap/event/meteor/quadrant/comet,/turf/unsimulated/map,/area/overmap)
"aw" = (/obj/effect/quadrant_border/betaquadrant,/obj/effect/quadrant_title/betaquadrant,/turf/unsimulated/map,/area/overmap)
"ax" = (/obj/effect/quadrant_border/hamletjean,/obj/effect/overmap/event/meteor/quadrant/asteroid,/turf/unsimulated/map,/area/overmap)
"ay" = (/obj/effect/quadrant_border/neutralzone,/obj/effect/overmap/event/meteor/quadrant/comet,/turf/unsimulated/map,/area/overmap)
"az" = (/obj/effect/quadrant_border/thepeel,/obj/effect/overmap/event/meteor/quadrant/asteroid,/turf/unsimulated/map,/area/overmap)
"aA" = (/obj/effect/quadrant_border/hopefullanding,/obj/effect/overmap/event/meteor/quadrant/asteroid,/turf/unsimulated/map,/area/overmap)
"aB" = (/obj/effect/quadrant_border/bufferzone,/obj/effect/overmap/event/meteor/quadrant/asteroid,/turf/unsimulated/map,/area/overmap)
"aC" = (/obj/effect/quadrant_border/domdaniel,/obj/effect/overmap/event/meteor/quadrant/asteroid,/turf/unsimulated/map,/area/overmap)
"aD" = (/obj/effect/quadrant_border/southernrim,/obj/effect/overmap/event/meteor/quadrant/asteroid,/turf/unsimulated/map,/area/overmap)
"aE" = (/obj/effect/quadrant_border/neutralzone,/obj/effect/overmap/event/meteor/quadrant/asteroid,/turf/unsimulated/map,/area/overmap)
"aF" = (/obj/effect/quadrant_border/borderterritory,/obj/effect/overmap/event/meteor/quadrant/asteroid,/turf/unsimulated/map,/area/overmap)
"aG" = (/obj/effect/quadrant_border/borderterritory,/obj/effect/overmap/event/meteor/quadrant/comet,/turf/unsimulated/map,/area/overmap)
"aH" = (/obj/effect/quadrant_border/wildspace,/obj/effect/overmap/event/meteor/quadrant/asteroid,/turf/unsimulated/map,/area/overmap)
"aI" = (/obj/effect/quadrant_border/trasenterritory,/obj/effect/overmap/event/meteor/quadrant/asteroid,/turf/unsimulated/map,/area/overmap)
"aJ" = (/obj/effect/quadrant_border/wildspace,/obj/effect/overmap/event/meteor/quadrant/comet,/turf/unsimulated/map,/area/overmap)
"aK" = (/obj/effect/quadrant_border/trasenterritory,/obj/effect/overmap/event/meteor/quadrant/comet,/turf/unsimulated/map,/area/overmap)
"aL" = (/obj/effect/quadrant_border/betaquadrant,/obj/effect/overmap/trade_beacon/terrantitan,/turf/unsimulated/map,/area/overmap)
"aM" = (/obj/effect/quadrant_border/alphaquadrant,/obj/effect/overmap/event/meteor/quadrant/asteroid,/turf/unsimulated/map,/area/overmap)
"aN" = (/obj/effect/quadrant_border/alphaquadrant,/obj/effect/overmap/event/meteor/quadrant/comet,/turf/unsimulated/map,/area/overmap)
"aO" = (/obj/effect/quadrant_border/betaquadrant,/obj/effect/overmap/event/ion,/turf/unsimulated/map,/area/overmap)
"aP" = (/obj/effect/quadrant_border/betaquadrant,/obj/effect/overmap/event/dust,/turf/unsimulated/map,/area/overmap)
"aQ" = (/obj/effect/quadrant_border/borderterritory,/obj/effect/overmap/event/electric,/turf/unsimulated/map,/area/overmap)
"aR" = (/obj/effect/quadrant_border/borderterritory,/obj/effect/overmap/event/ion,/turf/unsimulated/map,/area/overmap)
"aS" = (/obj/effect/quadrant_border/betaquadrant,/obj/effect/overmap/event/electric,/turf/unsimulated/map,/area/overmap)
"aT" = (/obj/effect/quadrant_border/borderterritory,/obj/effect/overmap/event/dust,/turf/unsimulated/map,/area/overmap)
"aU" = (/obj/effect/quadrant_border/betaquadrant,/obj/effect/overmap/event/ion,/obj/effect/overmap/event/ion,/turf/unsimulated/map,/area/overmap)
"aV" = (/obj/effect/quadrant_border/trasenterritory,/obj/effect/overmap/event/ion,/turf/unsimulated/map,/area/overmap)
"aW" = (/obj/effect/quadrant_border/wildspace,/obj/effect/overmap/event/dust,/turf/unsimulated/map,/area/overmap)
"aX" = (/obj/effect/quadrant_border/trasenterritory,/obj/effect/overmap/event/electric,/turf/unsimulated/map,/area/overmap)
"aY" = (/obj/effect/quadrant_border/alphaquadrant,/obj/effect/overmap/event/dust,/turf/unsimulated/map,/area/overmap)
"aZ" = (/obj/effect/quadrant_border/trasenterritory,/obj/effect/overmap/event/dust,/turf/unsimulated/map,/area/overmap)
"ba" = (/obj/effect/quadrant_border/wildspace,/obj/effect/overmap/event/electric,/turf/unsimulated/map,/area/overmap)
"bb" = (/obj/effect/quadrant_border/alphaquadrant,/obj/effect/overmap/event/ion,/turf/unsimulated/map,/area/overmap)
"bc" = (/obj/effect/quadrant_border/xanadu,/obj/effect/overmap/event/dust,/turf/unsimulated/map,/area/overmap)
"bd" = (/obj/effect/quadrant_border/xanadu,/obj/effect/overmap/visitable/sector/exoplanet/kleibkhar,/turf/unsimulated/map,/area/overmap)
"be" = (/obj/effect/quadrant_border/hamletjean,/obj/effect/overmap/event/dust,/turf/unsimulated/map,/area/overmap)
"bf" = (/obj/effect/quadrant_border/thepeel,/obj/effect/overmap/event/dust,/turf/unsimulated/map,/area/overmap)
"bg" = (/obj/effect/quadrant_border/neutralzone,/obj/effect/overmap/event/dust,/turf/unsimulated/map,/area/overmap)
"bh" = (/obj/effect/quadrant_border/hopefullanding,/obj/effect/overmap/event/ion,/turf/unsimulated/map,/area/overmap)
"bi" = (/obj/effect/quadrant_border/bufferzone,/obj/effect/overmap/event/dust,/turf/unsimulated/map,/area/overmap)
"bj" = (/obj/effect/quadrant_border/borderterritory,/obj/effect/overmap/trade_beacon/huntershall,/turf/unsimulated/map,/area/overmap)
"bk" = (/obj/effect/quadrant_border/southernrim,/obj/effect/overmap/event/dust,/turf/unsimulated/map,/area/overmap)
"bl" = (/obj/effect/quadrant_border/neutralzone,/obj/effect/overmap/event/ion,/turf/unsimulated/map,/area/overmap)
"bm" = (/obj/effect/quadrant_border/hopefullanding,/obj/effect/overmap/event/dust,/turf/unsimulated/map,/area/overmap)
"bn" = (/obj/effect/quadrant_border/domdaniel,/obj/effect/overmap/event/dust,/turf/unsimulated/map,/area/overmap)
"bo" = (/obj/effect/quadrant_border/bufferzone,/obj/effect/overmap/event/ion,/turf/unsimulated/map,/area/overmap)
"bp" = (/obj/effect/quadrant_border/wildspace,/obj/effect/overmap/trade_beacon/cash4nebu,/turf/unsimulated/map,/area/overmap)
"bq" = (/obj/effect/quadrant_border/neutralzone,/obj/effect/overmap/event/electric,/turf/unsimulated/map,/area/overmap)
"br" = (/obj/effect/quadrant_border/domdaniel,/obj/effect/overmap/event/electric,/turf/unsimulated/map,/area/overmap)
"bs" = (/obj/effect/quadrant_border/bufferzone,/obj/effect/overmap/event/electric,/turf/unsimulated/map,/area/overmap)
"bt" = (/obj/effect/quadrant_border/southernrim,/obj/effect/overmap/event/electric,/turf/unsimulated/map,/area/overmap)
"bu" = (/obj/effect/quadrant_border/trasenterritory,/obj/effect/overmap/trade_beacon/nanotrasenmemorial,/turf/unsimulated/map,/area/overmap)
"bv" = (/obj/effect/quadrant_border/borderterritory,/obj/effect/quadrant_title/borderterritory,/turf/unsimulated/map,/area/overmap)
"bw" = (/obj/effect/quadrant_border/wildspace,/obj/effect/quadrant_title/wildspace,/turf/unsimulated/map,/area/overmap)
"bx" = (/obj/effect/quadrant_border/trasenterritory,/obj/effect/quadrant_title/trasenterritory,/turf/unsimulated/map,/area/overmap)
"by" = (/obj/effect/quadrant_border/xanadu,/obj/effect/quadrant_title/xanadu,/turf/unsimulated/map,/area/overmap)
"bz" = (/obj/effect/quadrant_border/alphaquadrant,/obj/effect/quadrant_title/alphaquadrant,/turf/unsimulated/map,/area/overmap)
"bA" = (/obj/effect/quadrant_border/hamletjean,/obj/effect/quadrant_title/hamletjean,/turf/unsimulated/map,/area/overmap)
"bB" = (/obj/effect/quadrant_border/thepeel,/obj/effect/quadrant_title/thepeel,/turf/unsimulated/map,/area/overmap)
"bC" = (/obj/effect/quadrant_border/neutralzone,/obj/effect/overmap/event/dust,/obj/effect/quadrant_title/neutralzone,/turf/unsimulated/map,/area/overmap)
"bD" = (/obj/effect/quadrant_border/hopefullanding,/obj/effect/quadrant_title/hopefullanding,/turf/unsimulated/map,/area/overmap)
"bE" = (/obj/effect/quadrant_border/domdaniel,/obj/effect/quadrant_title/domdaniel,/turf/unsimulated/map,/area/overmap)
"bF" = (/obj/effect/quadrant_border/southernrim,/obj/effect/quadrant_title/southernrim,/turf/unsimulated/map,/area/overmap)
"bG" = (/obj/effect/quadrant_border/bufferzone,/obj/effect/quadrant_title/bufferzone,/turf/unsimulated/map,/area/overmap)
"bH" = (/obj/effect/quadrant_border/neutralzone,/obj/effect/quadrant_title/neutralzone,/turf/unsimulated/map,/area/overmap)
"bI" = (/obj/effect/quadrant_border/xanadu,/obj/effect/overmap/trade_beacon/dictashipwright,/turf/unsimulated/map,/area/overmap)
"bJ" = (/obj/effect/quadrant_border/alphaquadrant,/obj/effect/overmap/trade_beacon/alphaquad,/turf/unsimulated/map,/area/overmap)
"bK" = (/obj/effect/quadrant_border/xanadu,/obj/effect/overmap/trade_beacon/gerena,/turf/unsimulated/map,/area/overmap)
"bL" = (/obj/effect/quadrant_border/hamletjean,/obj/effect/overmap/trade_beacon/eddys,/turf/unsimulated/map,/area/overmap)
"bM" = (/obj/effect/quadrant_border/alphaquadrant,/obj/effect/overmap/trade_beacon/criminal/crone,/turf/unsimulated/map,/area/overmap)
"bN" = (/obj/effect/quadrant_border/hopefullanding,/obj/effect/overmap/trade_beacon/dredward,/turf/unsimulated/map,/area/overmap)
"bO" = (/obj/effect/quadrant_border/thepeel,/obj/effect/overmap/trade_beacon/corporateshipping,/turf/unsimulated/map,/area/overmap)
"bP" = (/obj/effect/quadrant_border/domdaniel,/obj/effect/overmap/trade_beacon/earthsgarden,/turf/unsimulated/map,/area/overmap)
"bQ" = (/obj/effect/quadrant_border/neutralzone,/obj/effect/overmap/trade_beacon/fruitflyjunction,/turf/unsimulated/map,/area/overmap)
"bR" = (/obj/effect/quadrant_border/bufferzone,/obj/effect/overmap/trade_beacon/moonlight,/turf/unsimulated/map,/area/overmap)
"bS" = (/obj/effect/quadrant_border/southernrim,/obj/effect/overmap/trade_beacon/jupitersoutpost,/turf/unsimulated/map,/area/overmap)
"bT" = (/obj/effect/quadrant_border/trasenterritory,/obj/effect/overmap/trade_beacon/criminal/syndicate,/turf/unsimulated/map,/area/overmap)
"bU" = (/obj/effect/quadrant_border/domdaniel,/obj/effect/overmap/trade_beacon/criminal/portfranco,/turf/unsimulated/map,/area/overmap)

(1,1,1) = {"
aaaaaaaaaaaaaaaaaaaaaaaaaaaaaaaaaaaaaaaaabababababababababababababababababababababababababababababab
aaacauacacacacacacacaOacacacacacaPacacaOadadadaQadadadadadadadaFadadadaGadadadadaFadadaGadadadadaRab
aaacacacacacaSacacacacaLacacavacacacacacadadadadadadadaRadadadadadadaTadadadadaQadadadadadadadadadab
aaacacacacacacacacacawacacacacacacacacacadadaeaeaeadadadadadadadadadadadadadadadadadadbjadadaFadadab
aaacacacacacafafacacacaPacacacacacacacacaeaeaeaeaeaeaeaiaiaiaiaiaiaiaiaiaiadaRadadadadadadadadadadab
aaaSacacacafafafacaOacacacacacacaUacacacaeaeaeaeaeaeaeaiaiaiaVaiaiaiaiaiaiadadadadadadbvadadadadadab
aaacacafafafafafacacacacacaSacacacacacacaeaeaeaHaeaeaeaiaiaiaiaiaiaiaiaiaiaiaiaiadadaQadaRaRadadadab
aaacacafafafafafacaPacacaOacacaeaeaeaeaeaeaeaeaeaeaWaeaeaiaiaiaiaiaiaIaiaiaiaiaiadadadadadadadadadab
aaacacafafafafafacacacacacacacaeaeaeaeaWaeaebpaeaeaeaeaeaXaiaiaiaiaibTaiaiaiaiaiaiaiaiadadadadadadab
aaacacafafaYafafafacacacaeaeaeaeaJaebwaeaeaeaeaeaeaHaeaeaiaZaiaiaiaVaiaiaZaiaiaiaIaiaiadadadadaFadab
aaaSacafafafafafafafafafaeaWaeaeaeaeaebaaeaeaWaeaeaeaeaeaiaiaiaiaiaibxaiaiaiaiaiaiaiaiaiadadaRadadab
aaacacafbbafafafafafaYafaeaeaeaeaeaeaeaeaeaeaeaeaeaeaeaiaiaiaiaiaiaiaiaiaiaiaiaiaiaiaiaiadadadadadab
aaacafafafaYafafafafafafaeaeaeaeaeaeaeaeaeaeaeaeaeaWaeajaiaiaiaiaiaiaiaiaiaiaiaiaiaiaiaiaiadadadadab
aaacafafafafafafafafafafakakakakakakakakakaeaeaeaeaeaeajajajajajajaiaiaiaiaVaiaibuaiaKaiaiadadadadab
aaafafafafafafafaYafakakakakakakakakakakakakakajajajajajajajajajajaiaiaZaiaiaiaiaiaiaiaiaiaiadadaQab
alafafbJafafaYafafafakakakakakakakbyakakakakakajajajajajajajajajajaiaiaiaiaiaiaiaXaiaiaiaiaiadadadab
alafbzafafafafafafafakakakakakbKakakakbcakakakajajajajajajajajajajajaiaiaiaiaiaiaiaiaiaiaiaiaZadadab
alafafafafaYafaYafafakakakakakbdakakakakakakakajajajajajbeajajajajajajajajajajajaiaiaiaiaiaiaiadadab
alaMafafafafafafafafakakakakakbIakakakakakakakajajajajajbAajajajajajajajajajajajaiaiaZaiaiaiaiadadab
alafafafaYafafafafakakakakakakakakakakakakakakajajajajajajajajajajajajajaxajajajaiaiaiaiaiaiaiamaman
alafafafafafafafakakakakbcakakakakakakakakakakajajajajajajajajajbeajbLajajajajajajamamamamamamamaman
alafaNafaYafafakakakakakakakakakakapapapapapapapapapapajajajajajajajajajajajajajajamamamamamamamaman
alafafafafafafakakakakakakakapapapapapapapbfapapapapapapapapajajajajajajajajajajajamamambgamamamaman
albMafafafaYaqaqaqaqaqaqakapapapapapapapapapapapapapapapapapajajajajajajajajajajajamamamamamamamayan
alafafaMafafaqaqaqaqaqaqaqapapapapaqaqaqaqaqapapapapapapapapajajajajajajajajajajaoaoamamamamamamaEan
alaYafafafaqaqaqaqaqaqaqaqapaqaqaqaqaqaqaqapapaparapapasasapapajajajajaoaoaoaoaoaoaoamamamayamamaman
alafafafafaqaqaqbhaqaqaqaqaqaqaqaqaqaqapapapapapapapapasasasasasasaoaoaoaoaobiaoaoaoamamamamamamaman
agahahbkaqaqaqaqaqaqaqaqaqaqaqaqaqapapapapapapapapapapasasasasasasaoaoaoaoaoaoaobiaoamblamamamamaman
agahahahaqaqaqbNaqaqaqaqaqaqaqaqaqapapapapbBapapapapasasasasasasasaoaoaoaoaoaoaoaoaoamamamambCamaman
agahahahaqaqaqaqbDaqaqaqaqbmaqaqapapapapapapapapapasasasasasasasasaoaobiaoaoaoaoaoaoamamamamamamayan
agbkahaqaqaqaAaqaqaqaqaqaqaqaqaqapapapapbOapapapasasasasasasbPasasaoaoaoaoaoaoaoaoaoaoambgamambQaman
agahahaqaqaqaqaqaqaqaqaqaqapapapapapapapapapapasasasasasasasasasasaoaoaoaoaoaoaoaoaoaoamamamaEamaman
agahahaqaqaqaqaqaqaqaqaqapapapapapapbfapapapapasasasasasasbnasasaoaoaoaoboaoaoaoaBaoaoamamamamamaman
agahbkahaqaqaqaqaqaqaqaqapapazapapapapapapasasasbEasasasasasasasaoaoaoaoaoaoaoaoaoaoaoaoaoamamamaman
agahahahbkahahaqaqaqaqaqapapapapapapapasasasasasasasasasasasasasaoaoaoaoaoaoaoaoaoaoaoaoaoamamamaman
agahbkahahahbkaqaqaAaqapapapapapapazapasasasasasasasasasasasasasaoaoaobiaoaoaoaoaoaoaoaoamambqamaman
agahbFahahahahaqaqaqaqapapapapapapasasasasasaCasbrasasasasaoaoaoaoaoaobGaoaoaoaoaobsaoaoamamamamaman
agahahahahbtahaqaqaqaqapapapasasasasasasasasasasasasaoaoaoaoaoaoaoaoaoaoaoaobiaoaoaoaoaoaoamamamaman
agahahahahahahahbkbkahapapapasasasasasasbUasasasasasaoaoaobiaoaoaobiaoaoaoaoaoaoaoaoaobiaoamamamaman
agahahaDahahahahahahahahahahasasasasaCasasasasaCasaoaoaoaoaoaoaoaoaoaoaoaBaoaoaoaoaoaoaoaoamamblaman
agahahahahahahbkahahahahahahahasasasasasasasasasasaoaoaoaBaoaoaobRaoaoaoaoaoaoaoaoaoaoaoaoamamamaman
agahahahahahahahbkahbkahahbkahasasasasasasasasasasaoaoaoaoaoaoaoaoaoaoaoaoaoaoaoaoaoaoaoaoamamblaman
agbkahahahahahahahahahahahaDahahahasasasahahbkahahaoaoaoaoaoaoaoaoaoaoaoaoaoaoaoamamamamamamamamaman
agahahahahbSahahahahahahahahahahbkahahahahahahahamamaoaoaoaoaoaoaoamamamamaoaoaoamamamamamamamamaman
agahahahahahahahatbtahahahahahahahahahahbkahahamamamamamamamamamamamamamamamamamamamamamamamamamaman
agahahahahbkahahahahahahahahahahahahahahahahahamamamamambgamamamamamaEamambqamambqamamamaEamamamaman
agbtahahaDahahahahahahahahahahbFbkahahahahbkahahamamamblambqamamamamambgamamamamamamamamamamamamaman
agahahahahahahahahahahbkahahahahahahahahahahahahamamamamamambHamamamamamamamamamamamamamamambqamaman
agbkahahahahahahahahahahahahaDahahahahahamamamamamambqamamamamamamambqamambgamaEamamamamamamamamaman
agagagagagagagagagagagagagagagagagagagaganananananananananananananananananananananananananananananan
"}
