//MAP CONVERTED BY dmm2tgm.py THIS HEADER COMMENT PREVENTS RECONVERSION, DO NOT REMOVE
"Hk" = (
/turf/space,
/area/space)
"UM" = (
/obj/effect/landmark/test/space_turf,
/turf/space,
/area/space)

(1,1,1) = {"
Hk
Hk
Hk
Hk
Hk
Hk
Hk
Hk
Hk
Hk
Hk
Hk
Hk
Hk
Hk
Hk
Hk
Hk
Hk
Hk
Hk
Hk
Hk
Hk
Hk
Hk
Hk
Hk
Hk
Hk
Hk
UM
"}
(2,1,1) = {"
Hk
Hk
Hk
Hk
Hk
Hk
Hk
Hk
Hk
Hk
Hk
Hk
Hk
Hk
Hk
Hk
Hk
Hk
Hk
Hk
Hk
Hk
Hk
Hk
Hk
Hk
Hk
Hk
Hk
Hk
Hk
Hk
"}
(3,1,1) = {"
Hk
Hk
Hk
Hk
Hk
Hk
Hk
Hk
Hk
Hk
Hk
Hk
Hk
Hk
Hk
Hk
Hk
Hk
Hk
Hk
Hk
Hk
Hk
Hk
Hk
Hk
Hk
Hk
Hk
Hk
Hk
Hk
"}
(4,1,1) = {"
Hk
Hk
Hk
Hk
Hk
Hk
Hk
Hk
Hk
Hk
Hk
Hk
Hk
Hk
Hk
Hk
Hk
Hk
Hk
Hk
Hk
Hk
Hk
Hk
Hk
Hk
Hk
Hk
Hk
Hk
Hk
Hk
"}
(5,1,1) = {"
Hk
Hk
Hk
Hk
Hk
Hk
Hk
Hk
Hk
Hk
Hk
Hk
Hk
Hk
Hk
Hk
Hk
Hk
Hk
Hk
Hk
Hk
Hk
Hk
Hk
Hk
Hk
Hk
Hk
Hk
Hk
Hk
"}
(6,1,1) = {"
Hk
Hk
Hk
Hk
Hk
Hk
Hk
Hk
Hk
Hk
Hk
Hk
Hk
Hk
Hk
Hk
Hk
Hk
Hk
Hk
Hk
Hk
Hk
Hk
Hk
Hk
Hk
Hk
Hk
Hk
Hk
Hk
"}
(7,1,1) = {"
Hk
Hk
Hk
Hk
Hk
Hk
Hk
Hk
Hk
Hk
Hk
Hk
Hk
Hk
Hk
Hk
Hk
Hk
Hk
Hk
Hk
Hk
Hk
Hk
Hk
Hk
Hk
Hk
Hk
Hk
Hk
Hk
"}
(8,1,1) = {"
Hk
Hk
Hk
Hk
Hk
Hk
Hk
Hk
Hk
Hk
Hk
Hk
Hk
Hk
Hk
Hk
Hk
Hk
Hk
Hk
Hk
Hk
Hk
Hk
Hk
Hk
Hk
Hk
Hk
Hk
Hk
Hk
"}
(9,1,1) = {"
Hk
Hk
Hk
Hk
Hk
Hk
Hk
Hk
Hk
Hk
Hk
Hk
Hk
Hk
Hk
Hk
Hk
Hk
Hk
Hk
Hk
Hk
Hk
Hk
Hk
Hk
Hk
Hk
Hk
Hk
Hk
Hk
"}
(10,1,1) = {"
Hk
Hk
Hk
Hk
Hk
Hk
Hk
Hk
Hk
Hk
Hk
Hk
Hk
Hk
Hk
Hk
Hk
Hk
Hk
Hk
Hk
Hk
Hk
Hk
Hk
Hk
Hk
Hk
Hk
Hk
Hk
Hk
"}
(11,1,1) = {"
Hk
Hk
Hk
Hk
Hk
Hk
Hk
Hk
Hk
Hk
Hk
Hk
Hk
Hk
Hk
Hk
Hk
Hk
Hk
Hk
Hk
Hk
Hk
Hk
Hk
Hk
Hk
Hk
Hk
Hk
Hk
Hk
"}
(12,1,1) = {"
Hk
Hk
Hk
Hk
Hk
Hk
Hk
Hk
Hk
Hk
Hk
Hk
Hk
Hk
Hk
Hk
Hk
Hk
Hk
Hk
Hk
Hk
Hk
Hk
Hk
Hk
Hk
Hk
Hk
Hk
Hk
Hk
"}
(13,1,1) = {"
Hk
Hk
Hk
Hk
Hk
Hk
Hk
Hk
Hk
Hk
Hk
Hk
Hk
Hk
Hk
Hk
Hk
Hk
Hk
Hk
Hk
Hk
Hk
Hk
Hk
Hk
Hk
Hk
Hk
Hk
Hk
Hk
"}
(14,1,1) = {"
Hk
Hk
Hk
Hk
Hk
Hk
Hk
Hk
Hk
Hk
Hk
Hk
Hk
Hk
Hk
Hk
Hk
Hk
Hk
Hk
Hk
Hk
Hk
Hk
Hk
Hk
Hk
Hk
Hk
Hk
Hk
Hk
"}
(15,1,1) = {"
Hk
Hk
Hk
Hk
Hk
Hk
Hk
Hk
Hk
Hk
Hk
Hk
Hk
Hk
Hk
Hk
Hk
Hk
Hk
Hk
Hk
Hk
Hk
Hk
Hk
Hk
Hk
Hk
Hk
Hk
Hk
Hk
"}
(16,1,1) = {"
Hk
Hk
Hk
Hk
Hk
Hk
Hk
Hk
Hk
Hk
Hk
Hk
Hk
Hk
Hk
Hk
Hk
Hk
Hk
Hk
Hk
Hk
Hk
Hk
Hk
Hk
Hk
Hk
Hk
Hk
Hk
Hk
"}
(17,1,1) = {"
Hk
Hk
Hk
Hk
Hk
Hk
Hk
Hk
Hk
Hk
Hk
Hk
Hk
Hk
Hk
Hk
Hk
Hk
Hk
Hk
Hk
Hk
Hk
Hk
Hk
Hk
Hk
Hk
Hk
Hk
Hk
Hk
"}
(18,1,1) = {"
Hk
Hk
Hk
Hk
Hk
Hk
Hk
Hk
Hk
Hk
Hk
Hk
Hk
Hk
Hk
Hk
Hk
Hk
Hk
Hk
Hk
Hk
Hk
Hk
Hk
Hk
Hk
Hk
Hk
Hk
Hk
Hk
"}
(19,1,1) = {"
Hk
Hk
Hk
Hk
Hk
Hk
Hk
Hk
Hk
Hk
Hk
Hk
Hk
Hk
Hk
Hk
Hk
Hk
Hk
Hk
Hk
Hk
Hk
Hk
Hk
Hk
Hk
Hk
Hk
Hk
Hk
Hk
"}
(20,1,1) = {"
Hk
Hk
Hk
Hk
Hk
Hk
Hk
Hk
Hk
Hk
Hk
Hk
Hk
Hk
Hk
Hk
Hk
Hk
Hk
Hk
Hk
Hk
Hk
Hk
Hk
Hk
Hk
Hk
Hk
Hk
Hk
Hk
"}
(21,1,1) = {"
Hk
Hk
Hk
Hk
Hk
Hk
Hk
Hk
Hk
Hk
Hk
Hk
Hk
Hk
Hk
Hk
Hk
Hk
Hk
Hk
Hk
Hk
Hk
Hk
Hk
Hk
Hk
Hk
Hk
Hk
Hk
Hk
"}
(22,1,1) = {"
Hk
Hk
Hk
Hk
Hk
Hk
Hk
Hk
Hk
Hk
Hk
Hk
Hk
Hk
Hk
Hk
Hk
Hk
Hk
Hk
Hk
Hk
Hk
Hk
Hk
Hk
Hk
Hk
Hk
Hk
Hk
Hk
"}
(23,1,1) = {"
Hk
Hk
Hk
Hk
Hk
Hk
Hk
Hk
Hk
Hk
Hk
Hk
Hk
Hk
Hk
Hk
Hk
Hk
Hk
Hk
Hk
Hk
Hk
Hk
Hk
Hk
Hk
Hk
Hk
Hk
Hk
Hk
"}
(24,1,1) = {"
Hk
Hk
Hk
Hk
Hk
Hk
Hk
Hk
Hk
Hk
Hk
Hk
Hk
Hk
Hk
Hk
Hk
Hk
Hk
Hk
Hk
Hk
Hk
Hk
Hk
Hk
Hk
Hk
Hk
Hk
Hk
Hk
"}
(25,1,1) = {"
Hk
Hk
Hk
Hk
Hk
Hk
Hk
Hk
Hk
Hk
Hk
Hk
Hk
Hk
Hk
Hk
Hk
Hk
Hk
Hk
Hk
Hk
Hk
Hk
Hk
Hk
Hk
Hk
Hk
Hk
Hk
Hk
"}
(26,1,1) = {"
Hk
Hk
Hk
Hk
Hk
Hk
Hk
Hk
Hk
Hk
Hk
Hk
Hk
Hk
Hk
Hk
Hk
Hk
Hk
Hk
Hk
Hk
Hk
Hk
Hk
Hk
Hk
Hk
Hk
Hk
Hk
Hk
"}
(27,1,1) = {"
Hk
Hk
Hk
Hk
Hk
Hk
Hk
Hk
Hk
Hk
Hk
Hk
Hk
Hk
Hk
Hk
Hk
Hk
Hk
Hk
Hk
Hk
Hk
Hk
Hk
Hk
Hk
Hk
Hk
Hk
Hk
Hk
"}
(28,1,1) = {"
Hk
Hk
Hk
Hk
Hk
Hk
Hk
Hk
Hk
Hk
Hk
Hk
Hk
Hk
Hk
Hk
Hk
Hk
Hk
Hk
Hk
Hk
Hk
Hk
Hk
Hk
Hk
Hk
Hk
Hk
Hk
Hk
"}
(29,1,1) = {"
Hk
Hk
Hk
Hk
Hk
Hk
Hk
Hk
Hk
Hk
Hk
Hk
Hk
Hk
Hk
Hk
Hk
Hk
Hk
Hk
Hk
Hk
Hk
Hk
Hk
Hk
Hk
Hk
Hk
Hk
Hk
Hk
"}
(30,1,1) = {"
Hk
Hk
Hk
Hk
Hk
Hk
Hk
Hk
Hk
Hk
Hk
Hk
Hk
Hk
Hk
Hk
Hk
Hk
Hk
Hk
Hk
Hk
Hk
Hk
Hk
Hk
Hk
Hk
Hk
Hk
Hk
Hk
"}
(31,1,1) = {"
Hk
Hk
Hk
Hk
Hk
Hk
Hk
Hk
Hk
Hk
Hk
Hk
Hk
Hk
Hk
Hk
Hk
Hk
Hk
Hk
Hk
Hk
Hk
Hk
Hk
Hk
Hk
Hk
Hk
Hk
Hk
Hk
"}
(32,1,1) = {"
Hk
Hk
Hk
Hk
Hk
Hk
Hk
Hk
Hk
Hk
Hk
Hk
Hk
Hk
Hk
Hk
Hk
Hk
Hk
Hk
Hk
Hk
Hk
Hk
Hk
Hk
Hk
Hk
Hk
Hk
Hk
Hk
"}
(33,1,1) = {"
Hk
Hk
Hk
Hk
Hk
Hk
Hk
Hk
Hk
Hk
Hk
Hk
Hk
Hk
Hk
Hk
Hk
Hk
Hk
Hk
Hk
Hk
Hk
Hk
Hk
Hk
Hk
Hk
Hk
Hk
Hk
Hk
"}
(34,1,1) = {"
Hk
Hk
Hk
Hk
Hk
Hk
Hk
Hk
Hk
Hk
Hk
Hk
Hk
Hk
Hk
Hk
Hk
Hk
Hk
Hk
Hk
Hk
Hk
Hk
Hk
Hk
Hk
Hk
Hk
Hk
Hk
Hk
"}
(35,1,1) = {"
Hk
Hk
Hk
Hk
Hk
Hk
Hk
Hk
Hk
Hk
Hk
Hk
Hk
Hk
Hk
Hk
Hk
Hk
Hk
Hk
Hk
Hk
Hk
Hk
Hk
Hk
Hk
Hk
Hk
Hk
Hk
Hk
"}
(36,1,1) = {"
Hk
Hk
Hk
Hk
Hk
Hk
Hk
Hk
Hk
Hk
Hk
Hk
Hk
Hk
Hk
Hk
Hk
Hk
Hk
Hk
Hk
Hk
Hk
Hk
Hk
Hk
Hk
Hk
Hk
Hk
Hk
Hk
"}
(37,1,1) = {"
Hk
Hk
Hk
Hk
Hk
Hk
Hk
Hk
Hk
Hk
Hk
Hk
Hk
Hk
Hk
Hk
Hk
Hk
Hk
Hk
Hk
Hk
Hk
Hk
Hk
Hk
Hk
Hk
Hk
Hk
Hk
Hk
"}
(38,1,1) = {"
Hk
Hk
Hk
Hk
Hk
Hk
Hk
Hk
Hk
Hk
Hk
Hk
Hk
Hk
Hk
Hk
Hk
Hk
Hk
Hk
Hk
Hk
Hk
Hk
Hk
Hk
Hk
Hk
Hk
Hk
Hk
Hk
"}
(39,1,1) = {"
Hk
Hk
Hk
Hk
Hk
Hk
Hk
Hk
Hk
Hk
Hk
Hk
Hk
Hk
Hk
Hk
Hk
Hk
Hk
Hk
Hk
Hk
Hk
Hk
Hk
Hk
Hk
Hk
Hk
Hk
Hk
Hk
"}
(40,1,1) = {"
Hk
Hk
Hk
Hk
Hk
Hk
Hk
Hk
Hk
Hk
Hk
Hk
Hk
Hk
Hk
Hk
Hk
Hk
Hk
Hk
Hk
Hk
Hk
Hk
Hk
Hk
Hk
Hk
Hk
Hk
Hk
Hk
"}
(41,1,1) = {"
Hk
Hk
Hk
Hk
Hk
Hk
Hk
Hk
Hk
Hk
Hk
Hk
Hk
Hk
Hk
Hk
Hk
Hk
Hk
Hk
Hk
Hk
Hk
Hk
Hk
Hk
Hk
Hk
Hk
Hk
Hk
Hk
"}
(42,1,1) = {"
Hk
Hk
Hk
Hk
Hk
Hk
Hk
Hk
Hk
Hk
Hk
Hk
Hk
Hk
Hk
Hk
Hk
Hk
Hk
Hk
Hk
Hk
Hk
Hk
Hk
Hk
Hk
Hk
Hk
Hk
Hk
Hk
"}
(43,1,1) = {"
Hk
Hk
Hk
Hk
Hk
Hk
Hk
Hk
Hk
Hk
Hk
Hk
Hk
Hk
Hk
Hk
Hk
Hk
Hk
Hk
Hk
Hk
Hk
Hk
Hk
Hk
Hk
Hk
Hk
Hk
Hk
Hk
"}
(44,1,1) = {"
Hk
Hk
Hk
Hk
Hk
Hk
Hk
Hk
Hk
Hk
Hk
Hk
Hk
Hk
Hk
Hk
Hk
Hk
Hk
Hk
Hk
Hk
Hk
Hk
Hk
Hk
Hk
Hk
Hk
Hk
Hk
Hk
"}
(45,1,1) = {"
Hk
Hk
Hk
Hk
Hk
Hk
Hk
Hk
Hk
Hk
Hk
Hk
Hk
Hk
Hk
Hk
Hk
Hk
Hk
Hk
Hk
Hk
Hk
Hk
Hk
Hk
Hk
Hk
Hk
Hk
Hk
Hk
"}
(46,1,1) = {"
Hk
Hk
Hk
Hk
Hk
Hk
Hk
Hk
Hk
Hk
Hk
Hk
Hk
Hk
Hk
Hk
Hk
Hk
Hk
Hk
Hk
Hk
Hk
Hk
Hk
Hk
Hk
Hk
Hk
Hk
Hk
Hk
"}
(47,1,1) = {"
Hk
Hk
Hk
Hk
Hk
Hk
Hk
Hk
Hk
Hk
Hk
Hk
Hk
Hk
Hk
Hk
Hk
Hk
Hk
Hk
Hk
Hk
Hk
Hk
Hk
Hk
Hk
Hk
Hk
Hk
Hk
Hk
"}
(48,1,1) = {"
Hk
Hk
Hk
Hk
Hk
Hk
Hk
Hk
Hk
Hk
Hk
Hk
Hk
Hk
Hk
Hk
Hk
Hk
Hk
Hk
Hk
Hk
Hk
Hk
Hk
Hk
Hk
Hk
Hk
Hk
Hk
Hk
"}
