//MAP CONVERTED BY dmm2tgm.py THIS HEADER COMMENT PREVENTS RECONVERSION, DO NOT REMOVE
"a" = (
/turf/space/transit/east,
/area/space)
"b" = (
/obj/machinery/door/blast/shutters/indestructible{
	dir = 4;
	icon_state = "shutter1";
	id_tag = "_cargo_shuttle_doors"
	},
/obj/machinery/conveyor/indestructible{
	dir = 8;
	id_tag = "_cargo_shuttle_conveyors"
	},
/turf/simulated/floor/indestructible,
/area/shuttle/supply_shuttle)
"c" = (
/turf/simulated/wall/r_titanium/indestructible,
/area/shuttle/supply_shuttle)
"d" = (
/obj/structure/shuttle/engine/propulsion/burst{
	dir = 8
	},
/obj/machinery/button/blast_door/indestructible{
	dir = 8;
	icon_state = "blastctrl";
	id_tag = "_cargo_shuttle_doors";
	pixel_x = 0;
	pixel_y = -24
	},
/turf/simulated/floor/indestructible,
/area/shuttle/supply_shuttle)
"e" = (
/obj/machinery/conveyor/indestructible{
	dir = 8;
	id_tag = "_cargo_shuttle_conveyors"
	},
/obj/effect/floor_decal/industrial/outline/orange,
/turf/simulated/floor/indestructible,
/area/shuttle/supply_shuttle)
"f" = (
/turf/simulated/floor/indestructible,
/area/shuttle/supply_shuttle)
"g" = (
/obj/effect/floor_decal/industrial/outline/orange,
/obj/machinery/conveyor/indestructible{
	dir = 8;
	id_tag = "_cargo_shuttle_conveyors"
	},
/turf/simulated/floor/indestructible,
/area/shuttle/supply_shuttle)
"h" = (
/obj/machinery/door/airlock/hatch/indestructible{
	dir = 2;
	icon_state = "closed"
	},
/turf/simulated/floor/indestructible,
/area/shuttle/supply_shuttle)
"i" = (
/obj/effect/floor_decal/industrial/hatch/yellow,
/obj/structure/railing/mapped{
	dir = 8
	},
/turf/simulated/floor/indestructible,
/area/shuttle/supply_shuttle)
"j" = (
/obj/machinery/embedded_controller/radio/simple_docking_controller/indestructible{
	dir = 8;
	id_tag = "cargo_bay";
	pixel_x = 20;
	pixel_y = 0;
	tag_door = "_cargo_shuttle_doors"
	},
/turf/simulated/floor/indestructible,
/area/shuttle/supply_shuttle)
"l" = (
/obj/effect/floor_decal/industrial/outline/orange,
/obj/machinery/conveyor/indestructible{
	dir = 8;
	id_tag = "_cargo_shuttle_conveyors"
	},
/obj/effect/shuttle_landmark/supply/start,
/turf/simulated/floor/indestructible,
/area/shuttle/supply_shuttle)
"m" = (
/obj/structure/fake_computer{
	dir = 8
	},
/turf/simulated/floor/indestructible,
/area/shuttle/supply_shuttle)
"n" = (
/obj/structure/railing/mapped{
	dir = 8
	},
/turf/simulated/floor/indestructible,
/area/shuttle/supply_shuttle)
"o" = (
/obj/structure/shuttle/engine/propulsion/burst{
	dir = 8
	},
/turf/simulated/floor/indestructible,
/area/shuttle/supply_shuttle)
"p" = (
/obj/machinery/conveyor_switch/indestructible{
	id_tag = "_cargo_shuttle_conveyors"
	},
/obj/machinery/button/blast_door/indestructible{
	dir = 8;
	id_tag = "_cargo_shuttle_doors";
	pixel_x = 24;
	pixel_y = 0
	},
/turf/simulated/floor/indestructible,
/area/shuttle/supply_shuttle)
"r" = (
/obj/structure/shuttle/engine/heater{
	dir = 4;
	icon_state = "heater";
	pixel_x = -8;
	pixel_y = 0
	},
/turf/simulated/floor/indestructible,
/area/shuttle/supply_shuttle)

(1,1,1) = {"
a
a
a
a
a
a
a
a
a
a
a
"}
(2,1,1) = {"
a
d
c
b
b
b
b
b
c
o
a
"}
(3,1,1) = {"
a
r
c
e
e
e
e
e
c
r
a
"}
(4,1,1) = {"
a
a
c
e
e
e
e
e
c
a
a
"}
(5,1,1) = {"
a
a
c
g
g
g
g
g
c
a
a
"}
(6,1,1) = {"
a
a
c
g
g
l
g
g
c
a
a
"}
(7,1,1) = {"
a
a
c
g
g
g
g
g
c
a
a
"}
(8,1,1) = {"
a
a
h
i
n
n
n
i
h
a
a
"}
(9,1,1) = {"
a
a
c
p
j
m
f
p
c
a
a
"}
(10,1,1) = {"
a
a
c
c
c
c
c
c
c
a
a
"}
(11,1,1) = {"
a
a
a
a
a
a
a
a
a
a
a
"}
