//MAP CONVERTED BY dmm2tgm.py THIS HEADER COMMENT PREVENTS RECONVERSION, DO NOT REMOVE
"a" = (
/turf/unsimulated/wall,
/area/cargo_shuttle_dock)
"b" = (
/obj/machinery/door/blast/shutters/indestructible{
	dir = 4
	},
/obj/machinery/conveyor/indestructible{
	dir = 8
	},
/turf/simulated/floor/indestructible,
/area/shuttle/supply_shuttle)
"c" = (
/turf/simulated/wall/r_titanium/indestructible,
/area/shuttle/supply_shuttle)
"d" = (
/obj/structure/shuttle/engine/propulsion/burst{
	dir = 8
	},
/obj/machinery/button/blast_door/indestructible{
	dir = 8;
	pixel_x = 0;
	pixel_y = -24
	},
/turf/simulated/floor/indestructible/airless,
/area/shuttle/supply_shuttle)
"e" = (
/obj/machinery/conveyor/indestructible{
	dir = 8
	},
/obj/effect/floor_decal/industrial/outline/orange,
/turf/simulated/floor/indestructible,
/area/shuttle/supply_shuttle)
"f" = (
/turf/simulated/floor/indestructible,
/area/shuttle/supply_shuttle)
"g" = (
/obj/effect/floor_decal/industrial/outline/orange,
/obj/machinery/conveyor/indestructible{
	dir = 8
	},
/turf/simulated/floor/indestructible,
/area/shuttle/supply_shuttle)
"h" = (
/obj/machinery/door/airlock/hatch/indestructible{
	dir = 2
	},
/turf/simulated/floor/indestructible,
/area/shuttle/supply_shuttle)
"i" = (
/obj/structure/railing/mapped{
	dir = 8
	},
/obj/effect/floor_decal/industrial/hatch/yellow,
/turf/simulated/floor/indestructible,
/area/shuttle/supply_shuttle)
"j" = (
/obj/structure/shuttle/engine/heater{
	dir = 4;
	pixel_x = -8;
	pixel_y = 0
	},
/obj/structure/sign/warning/hot_exhaust/indestructible{
	dir = 1
	},
/turf/simulated/floor/indestructible/airless,
/area/shuttle/supply_shuttle)
"k" = (
/obj/machinery/embedded_controller/radio/simple_docking_controller/indestructible/supply_offsite,
/turf/unsimulated/floor/tiled/steel_grid,
/area/cargo_shuttle_dock)
"l" = (
/obj/effect/floor_decal/industrial/outline/orange,
/obj/machinery/conveyor/indestructible{
	dir = 8
	},
/obj/effect/shuttle_landmark/supply/offsite,
/turf/simulated/floor/indestructible,
/area/shuttle/supply_shuttle)
"m" = (
/obj/machinery/door/blast/shutters/indestructible{
	dir = 4
	},
/obj/machinery/conveyor/indestructible{
	dir = 8
	},
/obj/machinery/conveyor_switch/indestructible{
	pixel_x = -12;
	pixel_y = -16
	},
/turf/simulated/floor/indestructible,
/area/shuttle/supply_shuttle)
"n" = (
/obj/structure/railing/mapped{
	dir = 8
	},
/turf/simulated/floor/indestructible,
/area/shuttle/supply_shuttle)
"o" = (
/obj/structure/shuttle/engine/propulsion/burst{
	dir = 8
	},
/turf/simulated/floor/indestructible/airless,
/area/shuttle/supply_shuttle)
"p" = (
/obj/machinery/conveyor_switch/indestructible,
/obj/machinery/button/blast_door/indestructible{
	dir = 8;
	pixel_x = 24;
	pixel_y = 0
	},
/turf/simulated/floor/indestructible,
/area/shuttle/supply_shuttle)
"q" = (
/turf/simulated/wall/r_titanium/indestructible,
/area/cargo_shuttle_dock)
"r" = (
/obj/effect/floor_decal/industrial/hatch/yellow,
/obj/chargen/light{
	dir = 1
	},
/turf/simulated/floor/indestructible,
/area/shuttle/supply_shuttle)
"s" = (
/obj/chargen/airlock,
/turf/unsimulated/floor/tiled/steel_ridged,
/area/cargo_shuttle_dock)
"t" = (
/turf/unsimulated/floor/tiled/steel_grid,
/area/cargo_shuttle_dock)
"u" = (
/obj/machinery/conveyor/indestructible{
	dir = 8
	},
/obj/effect/floor_decal/industrial/outline/orange,
/obj/structure/railing/mapped{
	dir = 1
	},
/turf/simulated/floor/indestructible,
/area/shuttle/supply_shuttle)
"v" = (
/obj/structure/plasticflaps/airtight/indestructible,
/obj/machinery/door/blast/shutters/indestructible/supply_dock{
	dir = 4
	},
/turf/unsimulated/floor/tiled/steel_ridged,
/area/cargo_shuttle_dock)
"x" = (
/obj/effect/floor_decal/industrial/outline/orange,
/obj/machinery/conveyor/indestructible{
	dir = 8
	},
/obj/structure/railing/mapped{
	dir = 1
	},
/turf/simulated/floor/indestructible,
/area/shuttle/supply_shuttle)
"y" = (
/obj/machinery/conveyor/indestructible{
	dir = 8
	},
/obj/effect/floor_decal/industrial/outline/orange,
/obj/structure/railing/mapped,
/turf/simulated/floor/indestructible,
/area/shuttle/supply_shuttle)
"z" = (
/obj/effect/floor_decal/industrial/outline/orange,
/obj/machinery/conveyor/indestructible{
	dir = 8
	},
/obj/structure/railing/mapped,
/turf/simulated/floor/indestructible,
/area/shuttle/supply_shuttle)
"A" = (
/obj/effect/floor_decal/industrial/hatch/yellow,
/turf/simulated/floor/indestructible,
/area/shuttle/supply_shuttle)
"B" = (
/obj/machinery/conveyor/indestructible{
	dir = 8
	},
/obj/effect/floor_decal/industrial/outline/orange,
/obj/structure/railing/mapped{
	dir = 1
	},
/obj/chargen/light{
	dir = 1
	},
/turf/simulated/floor/indestructible,
/area/shuttle/supply_shuttle)
"C" = (
/obj/structure/fake_computer,
/obj/machinery/embedded_controller/radio/simple_docking_controller/indestructible/supply_shuttle{
	dir = 8;
	pixel_x = 20;
	pixel_y = 0
	},
/turf/simulated/floor/indestructible,
/area/shuttle/supply_shuttle)
"D" = (
/obj/chargen/light{
	dir = 4
	},
/turf/simulated/floor/indestructible,
/area/shuttle/supply_shuttle)
"E" = (
/obj/machinery/conveyor/indestructible{
	dir = 8
	},
/obj/effect/floor_decal/industrial/outline/orange,
/obj/structure/railing/mapped,
/obj/chargen/light,
/turf/simulated/floor/indestructible,
/area/shuttle/supply_shuttle)
"F" = (
/obj/effect/floor_decal/industrial/hatch/yellow,
/obj/chargen/light,
/turf/simulated/floor/indestructible,
/area/shuttle/supply_shuttle)
"G" = (
/obj/structure/shuttle/engine/heater{
	dir = 4;
	pixel_x = -8;
	pixel_y = 0
	},
/obj/structure/sign/warning/hot_exhaust/indestructible,
/turf/simulated/floor/indestructible/airless,
/area/shuttle/supply_shuttle)

(1,1,1) = {"
a
a
a
a
a
a
a
a
a
a
a
"}
(2,1,1) = {"
a
a
q
k
t
t
t
t
q
a
a
"}
(3,1,1) = {"
a
a
q
q
v
v
v
q
q
a
a
"}
(4,1,1) = {"
a
a
d
c
b
b
m
c
o
a
a
"}
(5,1,1) = {"
a
a
j
c
B
e
E
c
G
a
a
"}
(6,1,1) = {"
a
a
c
c
u
e
y
c
c
a
a
"}
(7,1,1) = {"
a
a
c
f
x
g
z
f
c
a
a
"}
(8,1,1) = {"
a
a
c
f
x
l
z
f
c
a
a
"}
(9,1,1) = {"
a
q
c
r
g
g
g
F
c
q
a
"}
(10,1,1) = {"
a
s
h
A
i
n
i
A
h
s
a
"}
(11,1,1) = {"
a
q
c
c
C
D
p
c
c
q
a
"}
(12,1,1) = {"
a
a
a
c
c
c
c
c
a
a
a
"}
(13,1,1) = {"
a
a
a
a
a
a
a
a
a
a
a
"}
